C=𝓒
g=𝓰
H=𝓗
h=𝓱
I=𝓘
L=𝓛
l=𝓵
N=𝓝
P=𝓟
Q=𝓠
R=𝓡
Z=𝓩
B=𝓑
e=𝓮
E=𝓔
F=𝓕
M=𝓜
o=𝓸
i=𝓲
D=𝓓
d=𝓭
j=𝓳
A=𝓐
G=𝓖
J=𝓙
K=𝓚
O=𝓞
S=𝓢
T=𝓣
U=𝓤
V=𝓥
W=𝓦
X=𝓧
Y=𝓨
a=𝓪
b=𝓫
c=𝓬
f=𝓯
k=𝓴
m=𝓶
n=𝓷
p=𝓹
q=𝓺
r=𝓻
s=𝓼
t=𝓽
u=𝓾
v=𝓿
w=𝔀
x=𝔁
y=𝔂
z=𝔃
