C=𝐶
g=𝑔
H=𝐻
h=ℎ
I=𝐼
L=𝐿
l=𝑙
N=𝑁
P=𝑃
Q=𝑄
R=𝑅
Z=𝑍
B=𝐵
e=𝑒
E=𝐸
F=𝐹
M=𝑀
o=𝑜
i=𝑖
π=𝜋
γ=𝛾
Γ=𝛤
Π=𝛱
D=𝐷
d=𝑑
j=𝑗
A=𝐴
G=𝐺
J=𝐽
K=𝐾
O=𝑂
S=𝑆
T=𝑇
U=𝑈
V=𝑉
W=𝑊
X=𝑋
Y=𝑌
a=𝑎
b=𝑏
c=𝑐
f=𝑓
k=𝑘
m=𝑚
n=𝑛
p=𝑝
q=𝑞
r=𝑟
s=𝑠
t=𝑡
u=𝑢
v=𝑣
w=𝑤
x=𝑥
y=𝑦
z=𝑧
ı=𝚤
ȷ=𝚥
Α=𝛢
Β=𝛣
Δ=𝛥
Ε=𝛦
Ζ=𝛧
Η=𝛨
Θ=𝛩
Ι=𝛪
Κ=𝛫
Λ=𝛬
Μ=𝛭
Ν=𝛮
Ξ=𝛯
Ο=𝛰
Ρ=𝛲
ϴ=𝛳
Σ=𝛴
Τ=𝛵
Υ=𝛶
Φ=𝛷
Χ=𝛸
Ψ=𝛹
Ω=𝛺
∇=𝛻
α=𝛼
β=𝛽
δ=𝛿
ε=𝜀
ζ=𝜁
η=𝜂
θ=𝜃
ι=𝜄
κ=𝜅
λ=𝜆
μ=𝜇
ν=𝜈
ξ=𝜉
ο=𝜊
ρ=𝜌
ς=𝜍
σ=𝜎
τ=𝜏
υ=𝜐
φ=𝜑
χ=𝜒
ψ=𝜓
ω=𝜔
∂=𝜕
ϵ=𝜖
ϑ=𝜗
ϰ=𝜘
ϕ=𝜙
ϱ=𝜚
ϖ=𝜛
