C=𝘊
g=𝘨
H=𝘏
h=𝘩
I=𝘐
L=𝘓
l=𝘭
N=𝘕
P=𝘗
Q=𝘘
R=𝘙
Z=𝘡
B=𝘉
e=𝘦
E=𝘌
F=𝘍
M=𝘔
o=𝘰
i=𝘪
D=𝘋
d=𝘥
j=𝘫
A=𝘈
G=𝘎
J=𝘑
K=𝘒
O=𝘖
S=𝘚
T=𝘛
U=𝘜
V=𝘝
W=𝘞
X=𝘟
Y=𝘠
a=𝘢
b=𝘣
c=𝘤
f=𝘧
k=𝘬
m=𝘮
n=𝘯
p=𝘱
q=𝘲
r=𝘳
s=𝘴
t=𝘵
u=𝘶
v=𝘷
w=𝘸
x=𝘹
y=𝘺
z=𝘻
