C=𝐂
g=𝐠
H=𝐇
h=𝐡
I=𝐈
L=𝐋
l=𝐥
N=𝐍
P=𝐏
Q=𝐐
R=𝐑
Z=𝐙
B=𝐁
e=𝐞
E=𝐄
F=𝐅
M=𝐌
o=𝐨
i=𝐢
π=𝛑
γ=𝛄
Γ=𝚪
Π=𝚷
D=𝐃
d=𝐝
j=𝐣
A=𝐀
G=𝐆
J=𝐉
K=𝐊
O=𝐎
S=𝐒
T=𝐓
U=𝐔
V=𝐕
W=𝐖
X=𝐗
Y=𝐘
a=𝐚
b=𝐛
c=𝐜
f=𝐟
k=𝐤
m=𝐦
n=𝐧
p=𝐩
q=𝐪
r=𝐫
s=𝐬
t=𝐭
u=𝐮
v=𝐯
w=𝐰
x=𝐱
y=𝐲
z=𝐳
Α=𝚨
Β=𝚩
Δ=𝚫
Ε=𝚬
Ζ=𝚭
Η=𝚮
Θ=𝚯
Ι=𝚰
Κ=𝚱
Λ=𝚲
Μ=𝚳
Ν=𝚴
Ξ=𝚵
Ο=𝚶
Ρ=𝚸
ϴ=𝚹
Σ=𝚺
Τ=𝚻
Υ=𝚼
Φ=𝚽
Χ=𝚾
Ψ=𝚿
Ω=𝛀
∇=𝛁
α=𝛂
β=𝛃
δ=𝛅
ε=𝛆
ζ=𝛇
η=𝛈
θ=𝛉
ι=𝛊
κ=𝛋
λ=𝛌
μ=𝛍
ν=𝛎
ξ=𝛏
ο=𝛐
ρ=𝛒
ς=𝛓
σ=𝛔
τ=𝛕
υ=𝛖
φ=𝛗
χ=𝛘
ψ=𝛙
ω=𝛚
∂=𝛛
ϵ=𝛜
ϑ=𝛝
ϰ=𝛞
ϕ=𝛟
ϱ=𝛠
ϖ=𝛡
Ϝ=𝟊
ϝ=𝟋
0=𝟎
1=𝟏
2=𝟐
3=𝟑
4=𝟒
5=𝟓
6=𝟔
7=𝟕
8=𝟖
9=𝟗
