C=𝕮
g=𝖌
H=𝕳
h=𝖍
I=𝕴
L=𝕷
l=𝖑
N=𝕹
P=𝕻
Q=𝕼
R=𝕽
Z=𝖅
B=𝕭
e=𝖊
E=𝕰
F=𝕱
M=𝕸
o=𝖔
i=𝖎
D=𝕯
d=𝖉
j=𝖏
A=𝕬
G=𝕲
J=𝕵
K=𝕶
O=𝕺
S=𝕾
T=𝕿
U=𝖀
V=𝖁
W=𝖂
X=𝖃
Y=𝖄
a=𝖆
b=𝖇
c=𝖈
f=𝖋
k=𝖐
m=𝖒
n=𝖓
p=𝖕
q=𝖖
r=𝖗
s=𝖘
t=𝖙
u=𝖚
v=𝖛
w=𝖜
x=𝖝
y=𝖞
z=𝖟
