C=𝘾
g=𝙜
H=𝙃
h=𝙝
I=𝙄
L=𝙇
l=𝙡
N=𝙉
P=𝙋
Q=𝙌
R=𝙍
Z=𝙕
B=𝘽
e=𝙚
E=𝙀
F=𝙁
M=𝙈
o=𝙤
i=𝙞
π=𝞹
γ=𝞬
Γ=𝞒
Π=𝞟
D=𝘿
d=𝙙
j=𝙟
A=𝘼
G=𝙂
J=𝙅
K=𝙆
O=𝙊
S=𝙎
T=𝙏
U=𝙐
V=𝙑
W=𝙒
X=𝙓
Y=𝙔
a=𝙖
b=𝙗
c=𝙘
f=𝙛
k=𝙠
m=𝙢
n=𝙣
p=𝙥
q=𝙦
r=𝙧
s=𝙨
t=𝙩
u=𝙪
v=𝙫
w=𝙬
x=𝙭
y=𝙮
z=𝙯
Α=𝞐
Β=𝞑
Δ=𝞓
Ε=𝞔
Ζ=𝞕
Η=𝞖
Θ=𝞗
Ι=𝞘
Κ=𝞙
Λ=𝞚
Μ=𝞛
Ν=𝞜
Ξ=𝞝
Ο=𝞞
Ρ=𝞠
ϴ=𝞡
Σ=𝞢
Τ=𝞣
Υ=𝞤
Φ=𝞥
Χ=𝞦
Ψ=𝞧
Ω=𝞨
∇=𝞩
α=𝞪
β=𝞫
δ=𝞭
ε=𝞮
ζ=𝞯
η=𝞰
θ=𝞱
ι=𝞲
κ=𝞳
λ=𝞴
μ=𝞵
ν=𝞶
ξ=𝞷
ο=𝞸
ρ=𝞺
ς=𝞻
σ=𝞼
τ=𝞽
υ=𝞾
φ=𝞿
χ=𝟀
ψ=𝟁
ω=𝟂
∂=𝟃
ϵ=𝟄
ϑ=𝟅
ϰ=𝟆
ϕ=𝟇
ϱ=𝟈
ϖ=𝟉
