C=𝑪
g=𝒈
H=𝑯
h=𝒉
I=𝑰
L=𝑳
l=𝒍
N=𝑵
P=𝑷
Q=𝑸
R=𝑹
Z=𝒁
B=𝑩
e=𝒆
E=𝑬
F=𝑭
M=𝑴
o=𝒐
i=𝒊
π=𝝅
γ=𝜸
Γ=𝜞
Π=𝜫
D=𝑫
d=𝒅
j=𝒋
A=𝑨
G=𝑮
J=𝑱
K=𝑲
O=𝑶
S=𝑺
T=𝑻
U=𝑼
V=𝑽
W=𝑾
X=𝑿
Y=𝒀
a=𝒂
b=𝒃
c=𝒄
f=𝒇
k=𝒌
m=𝒎
n=𝒏
p=𝒑
q=𝒒
r=𝒓
s=𝒔
t=𝒕
u=𝒖
v=𝒗
w=𝒘
x=𝒙
y=𝒚
z=𝒛
Α=𝜜
Β=𝜝
Δ=𝜟
Ε=𝜠
Ζ=𝜡
Η=𝜢
Θ=𝜣
Ι=𝜤
Κ=𝜥
Λ=𝜦
Μ=𝜧
Ν=𝜨
Ξ=𝜩
Ο=𝜪
Ρ=𝜬
ϴ=𝜭
Σ=𝜮
Τ=𝜯
Υ=𝜰
Φ=𝜱
Χ=𝜲
Ψ=𝜳
Ω=𝜴
∇=𝜵
α=𝜶
β=𝜷
δ=𝜹
ε=𝜺
ζ=𝜻
η=𝜼
θ=𝜽
ι=𝜾
κ=𝜿
λ=𝝀
μ=𝝁
ν=𝝂
ξ=𝝃
ο=𝝄
ρ=𝝆
ς=𝝇
σ=𝝈
τ=𝝉
υ=𝝊
φ=𝝋
χ=𝝌
ψ=𝝍
ω=𝝎
∂=𝝏
ϵ=𝝐
ϑ=𝝑
ϰ=𝝒
ϕ=𝝓
ϱ=𝝔
ϖ=𝝕
