g=𝔤
h=𝔥
L=𝔏
l=𝔩
N=𝔑
P=𝔓
Q=𝔔
B=𝔅
e=𝔢
E=𝔈
F=𝔉
M=𝔐
o=𝔬
i=𝔦
D=𝔇
d=𝔡
j=𝔧
A=𝔄
G=𝔊
J=𝔍
K=𝔎
O=𝔒
S=𝔖
T=𝔗
U=𝔘
V=𝔙
W=𝔚
X=𝔛
Y=𝔜
a=𝔞
b=𝔟
c=𝔠
f=𝔣
k=𝔨
m=𝔪
n=𝔫
p=𝔭
q=𝔮
r=𝔯
s=𝔰
t=𝔱
u=𝔲
v=𝔳
w=𝔴
x=𝔵
y=𝔶
z=𝔷
