C=𝒞
h=𝒽
l=𝓁
N=𝒩
P=𝒫
Q=𝒬
Z=𝒵
i=𝒾
D=𝒟
d=𝒹
j=𝒿
A=𝒜
G=𝒢
J=𝒥
K=𝒦
O=𝒪
S=𝒮
T=𝒯
U=𝒰
V=𝒱
W=𝒲
X=𝒳
Y=𝒴
a=𝒶
b=𝒷
c=𝒸
f=𝒻
k=𝓀
m=𝓂
n=𝓃
p=𝓅
q=𝓆
r=𝓇
s=𝓈
t=𝓉
u=𝓊
v=𝓋
w=𝓌
x=𝓍
y=𝓎
z=𝓏
